NO ./assets/spring_256.xpm
SO ./assets/autumn_256.xpm
WE ./assets/winter_256.xpm
EA ./assets/summer_256

F 150,185,81
C 161,223,0

111111111111111111111111
111111111N11111111111111
111111111111111