NO ./assets/spring_256.xpm
SO ./assets/autumn_256.xpm
WE ./assets/winter_256.xpm
EA ./assets/summer_256.xpm

F 150,185,81
C 161,223,248

111111111
1000000011
1000N00001
1000000011
111101111
   111