NO ./assets/spring_256.xpm
SO ./assets/autumn_256.xpm
WE ./assets/winter_256.xpm
EA ./assets/summer_256.xpm
F 220,100,0
C 225,30,0
1111111111111111111111111111111
1000000000000000000000000000001
1111100000000000000000000000001
1000000000N00000000000011111111
1000000000000000000000011111111
1000000000000000000000000000001
1111111111111111111111111111111