NO ./assets/spring_256.xpm
SO ./assets/autumn_256.xpm
WE ./assets/winter_256.xpm
EA ./assets/summer_256.xpm
F 220,100,0
C 225,30,0
111111111111111111
100000000000000001
100000000000000001
100000000000000001
100000000000000001
100000000000000001
10000W000000000001
100000000000000001
111111111111111111
